#########
#....%%%#
#....%%%#
#...^...#
#########


---
% sand
