###
#v#
#.##############
#.........A..X.#
#.........####.#
#.........#  #.#
#########.#
      #Q#.#
      #.#.#
      #...#
      #####

---
Q Floor [StepIn] [ChangeTile @A Floor]
A Floor
X Floor [StepIn] [NextLevel]
A BlueWall