######  #####
#v|..#  #...#
#.#######A#.####
#.........#..X.#
#.........####.#
#.........#  #.#
#########.#
      #Q#.#
      #.#.#
      #...#
      #####

---
Q Floor [StepIn] [PlaySound "rumble.mp3", ChangeTile @A Floor, RemoveAllTriggersInSector @Q]
A Floor
X Floor [StepIn] [NextLevel]
A Wall
| Wall