  ########################
  #%%%%%%1%#%%%I.....#...#
  #%######%#%#######.#.#.#
  #%#    #%#%%%%%# #.#.#.#
  #%#    #%#####%# #.#.#.#
  #%#    #%%%%%%%# #.#.#.#
###%###  ######### #...#^#
#%%%%%#            #######
#%%T%%#
#%%%%%#
#%%%%%#
#######

 %%%%%%%%%%%%%%%%%%%%%%%%
 %%%%%%%%%%%%%%%%%%%%%%%%
 %%%%%%%%%%%%%%%%%%%%%%%%
 %%%%%%%%%%%%%%%%%%%%%%%%
 %%%%%%%%%%%%%%%%%%%%%%%%
 %%%%%%%%%%%%%%%%%%%%%%%%
 %%%%%%%%%%%%%%%%%%%%%%%%
 %%%%%%%%%%%%%%%%%%%%%%%%
 %%%%%%%%%%%%%%%%%%%%%%%%
 %%%%%%%%%%%%%%%%%%%%%%%%
 %%%%%%%%%%%%%%%%%%%%%%%%
 %%%%%%%%%%%%%%%%%%%%%%%%
 %%%%%%%!!!!!!!!!%%%%%%%%
 %%%%%%%!%%%%%%%!%%%%%%%%
 %%%%%%%!%%%%%%%!%%%%%%%%
 %%%%%%%!%%%t%%%!%%%%%%%%
 %%%%%%%!%%%%%%%!%%%%%%%%
 %%%%%%%!%%%%%%%!%%%%%%%%
 %%%%%%%!%%%%%%%!%%%%%%%%
 %%%%%%%!%%%%%%%!%%%%%%%%
 %%%%%%%!%%%%%%%!%%%%%%%%
 %%%%%%%!%%%%%%%!%%%%%%%%
 %%%%%%%!%%%%%%%!%%%%%%%%
 %%%%%%%!%%%%%%%!%%%%%%%%
 %%%%%%%!%%%%%%%!%%%%%%%%
 %%%%%%%!%%%%%%%!%%%%%%%%
 %%%%%%%!%%%%%%%!%%%%%%%%
 %%%%%%%!%%%%%%%!%%%%%%%%
 %%%%%%%!%%%%%%%!%%%%%%%%
 %%%%%%%!%%%%%%%!%%%%%%%%
 %%%%%%%!%%%%%%%!%%%%%%%%
 %%%%%%%!%%%%%%%!%%%%%%%%
 %%%%%%%!%%%%%%%!%%%%%%%%
 %%%%%%%!%%%%%%%!%%%%%%%%
 %%%%%%%!3333333!%%%%%%%%
 %%%%%%%!%%%%%%%!%%%%%%%%
 %%%%%%%!%%%%%%%!%%%%%%%%
 %%%%%%%!%%%%%%%!%%%%%%%%
 %%%%%%%!%%%%%%%!%%%%%%%%
 %%%%%%%!%%%%%%%!%%%%%%%%
 %%%%%%%!%%%%%%%!%%%%%%%%
 %%%%%%%!%%%%%%%!%%%%%%%%
 %%%%%%%!%%%%%%%!%%%%%%%%
 %%%%%%%!4444444!%%%%%%%%
 %%%%%%%!%%%%%%%!%%%%%%%%
 %%%%%%%!%%%%%%%!%%%%%%%%
 %%%%%%%!%%%%%%%!%%%%%%%%
 %%%%%%%!%%%%%%%!%%%%%%%%
 %%%%%%%!!!!%!!!!%%%%%%%%
 %%%%%%%%%%!C!%%%%%%%%%%%
 %%%%%%%%%%%g%%%%%%%%%%%%

+++
+G+
+ +
+5+
+ +
+ +
+ +
+ +
+ +
+ +
+o+
+o+
+o+
+o+
+o+
+o+
+o+
+o+
+o+
+o+
+o+
+f+

#######
#.....#
#..s..#
#..x..#
+++F+++
  +++

       ##########
       #...#...##
       #.#.#.#.##
   #####.#.#.#.##
   #.....#9..#.##
   #.#########.##.#
   #.#       #..d.#
   #.#       ######
 ###_###
 #..8..#
 #..s..#
 #..X..#
 ###)###
#.##.#
#..D.#
######

%%%%%%%%%%%%%%%%%%%%%%%%%%%
%%%%%%%%%%%%%%%%%%%%%%%%%%%
%%%%%%%%%%%%%%%%%%%%%%%%%%%
%%%%%%%%%%%%%%%%%%%%%%%%%%%
%%%%%%%%%%%%%%%%%%%%%%%%%%%
%%%%%%%%%%%%%%%%%%%%%%%%%%%
%%%%%%%!!!!!!!!!!!!!%%%%%%%
%%%%%%%!%%%%%%%%%%%!%%%%%%%
%%%%%%%!%%%%%%%%%%%!%%%%%%%
%%%%%%%!%%%%%%%%%%%!%%%%%%%
%%%%%%%!%%%%%%%%%%%!%%%%%%%
%%%%%%%!%%%%%%%%%%%!%%%%%%%
%%%%%%%!%%%%%%%%%%%!%%%%%%%
       ?    #b#    ?
       ?    #.#    ?
       ?    #.#    ?
       ?    #.#    ?
       ?LLLL#.#LLLL?
       ?    #.#    ?
       ?    #b#    ?
       ?    #.#    ?
       ?????#.#?????
            #.#
            #b#
            #.#
            #.#???????????????????????#################
            #.loooooooooooooąooooooooo...............>.ó
            #.#???????????????????????#################
            #.#
            #.#
            #.#
            #b#
            #.#
            #.#
            #.#
            #.#
            #.#
            #.#
        #####B#
        #ś#Ś#.#
        #.#.#.#
        #.#.#.#
        #.#.#.#
        #.#.#.#
        #.#.#.#
        #.#.#.#
        #.#.#.#
        #.#.#.#
        #.#.#.#
        #.#ć#Ć#
   ######.#####
   #....#.#
   #.##.#.#
   #.##.#.#
   #.##...#
 ###.######
 #.....#
 #..S..#
 #..0..#
 ###.###
#.##.#
#..A.#
######

---
^ Floor [] [PlayMusic "ending_loop0.mp3", RemoveAllTriggersInSector @^]
% Sand
o OpenFloor
3 Sand [StepIn] [StartNarration 3, RemoveAllTriggersInSectors @3]
4 Sand [StepIn] [StartNarration 4, RemoveAllTriggersInSectors @4]
5 Empty [StepIn] [StartNarration 5, RemoveAllTriggersInSector @5]
1 Sand [StepIn] [StartNarration 1, RemoveAllTriggersInSector @1]
I Sand [StepIn] [PlayMusic "ending_loop1.mp3", InitFog Color.white (Length.meters 10), RemoveAllTriggersInSector @I]
T ToyBucket [LookingAtGround] [StartNarration 2, InitFog Color.white (Length.meters 5), Teleport @t, PlayMusic "ending_loop2.mp3"]
t ToyBucket
! (InvisibleWall Sand)
+ (InvisibleWall Empty)
C BigCastle
g Sand [] [Teleport @G]
G Empty [] [PlayMusic "ending_loop3.mp3", InitFog Color.black (Length.meters 0.75), RemoveAllTriggersInSector @G]
f Chair [StepIn, LookAngle South] [StartNarration 6, Teleport @F, SitDown, RemoveAllTriggersInSector @f]
F Chair
p Empty
s (Sandbox True)
S (Sandbox False)
x Floor [] [Teleport @X]
X Floor [] [StartNarration 7, RemoveAllTriggersInSector @X]
_ Wall
8 Floor [LookAngle South] [StartNarration 8, ChangeTile @_ Floor, RemoveAllTriggersInSector @8]
) Wall
D Floor
9 Floor [StepIn] [StartNarration 9, RemoveAllTriggersInSector @9]
d Floor [StepIn] [ChangeTile @) Floor, Teleport @D, RemoveAllTriggersInSector @d, CreateTrigger (Trigger @d [StepIn] [Teleport @A])]
0 Floor [StepIn] [StartNarration 10, RemoveAllTriggersInSector @0]
A Floor
ś Floor [LookAngle North] [Teleport @Ś]
Ś Floor
b (BreakableWall Glass)
B (BreakableWall Glass) [StepIn] [InitFog Color.white (Length.meters 0.5), PlayMusic "ending_loop4.mp3", StartNarration 12, RemoveAllTriggersInSector @B]
ć Floor [StepIn] [StartNarration 11, Teleport @Ć, RemoveAllTriggersInSector @ć]
Ć Floor
L Empty [StepIn] [StartNarration 13, ChangeTile @l Floor, RemoveAllTriggersInSectors @L]
l Wall
? (InvisibleWall Empty)
ą OpenFloor [StepIn] [PlayMusic "ending_loop2.mp3", RemoveAllTriggersInSector @ą]
ó Empty [StepIn] [ShowGameEndingScreen]
